############
#     X   O#
# X     ####
# O        #
#######    #
#    ##    #
#  P       #
#    O   X #
#          #
############
