######
#    #
#OXP #
#O#X #
#OX  #
######
