#########
#O     O#
#   P   #
#   X   #
#   X   #
#   X   #
#       #
#O     O#
#########
